11111111111111111111111111111
1P000000000000000000000000001
100101110C0000000110C00000C01
10110001C0C1010C010C0C011C0C1
11110111CCC110C0C01CCC100CCC1
10010100C0C1010C011C0C011C0C1
100101110000000000000000000E1
11111111111111111111111111111