11111
1P001
1CEC1
10001
11111