1111111111111111111110111111111111
100000000000000C00000C000000000001
1010010100100000101001000000010101
10100100101010100010010000000101E1
1P0000000C00C0000000000000000000C1
100000000000000C00000C000000000001
1111111111111111111111111111111111